1
1
***************
*             *            
*             |
*             *
*             *
* ***         *
*             *
*       ***   *
*             *
***************