1
1
***************************
*                         *
|                         *
*                         *
*                         *
*                         *
*      ***                *
*           ****          *
*                         *
*                         *
*                         *
*                         *
*          ****           *
*                         *
*                         *
***************************